################################################################################
#@.....#.#.............#.........#...#.........................................#
#......#.#.............#.........#.......#.....................................#
#......................#.........#.............................................#
##########............./.........#####..#.#.####################...............#
#........+.............#.........#..................#..#.......#...............#
##########.............###########..#...#...........#..#.......#.....###########
#........#.............#.........#..................#..#.............#.........#
#........#.........a...+.........#........#..#......#..#.......#.....#.........#
#........#.............#.........#>.....#...........#..........#.....#.........#
#......../.............#########################################.....+.........#
##########.............#.........#.#...........................#.....#.........#
#........+.............+.........#.#.................................#.........#
#........#.............#.........#.#...........................#.....#.........#
#........#.............###########+#############################.....###########
#........#.....................................................................#
#........######+##########/#######/#############/#############+###########+#####
#........#..........#...........#.........#.............#...........#..........#
#........#..........#...........#.........#.............#...........#..........#
################################################################################
