################################################################################
#@.....#.#.............#.........#...#.........................................#
#......#.#.............#.....i...#.......#.....................................#
#......................#.........#.............................................#
##########.......................#####..#.#.####################...............#
#...i..................#......i..#z...........e.....#..#.......#...............#
##########.............###########..#...#.........f.#..#.......#.....###########
#........#.............#.........#....d.........m...#..#.............#.........#
#...i....#.............+.........#.t......#..#......#..#.......#.....#.......i.#
#........#.............#.....i...#>...h.#...q...r...#..........#.....#.........#
#......................#########################################...............#
##########.............#.........#.#...........................#.....#.........#
#..................i...+.........#.#.................................#...i.....#
#........#.i...........#......i..#.#...........................#.....#.........#
#........#.............###########+#############################.....###########
#...i....#.....................................................................#
#........######.##########.#######.#############.#############.###########.#####
#........#..........#...........#.........#.............#...........#..........#
#........#.....i....#.....i.....#....i....#......i......#.....i.....#.....i....#
################################################################################